111111111
000000000
000000000
000000000
110000011

110000011
110000000
110000000
110000000
110000011

110000011
000000000
000000000
000000000
111111111

110000011
000000011
000000011
000000011
110000011

110000011
110000000
110000000
110000000
111111111

110000011
000000011
000000011
000000011
111111111

111111111
000000011
000000011
000000011
110000011

111111111
110000000
110000000
110000000
110000011

111111111
000000000
000000000
000000000
111111111

110000011
110000011
110000011
110000011
110000011

111111111
000000000
000000000
000000000
111111111

110000011
110000011
110000011
110000011
110000011

111111111
110000011
110000011
110000011
111111111

111111111
110000011
110000011
110000011
111111111

111111111
110000011
110000011
110000011
111111111

111111111
110000011
110000011
110000011
111111111

110000011
110000011
110000011
110000011
111111111

111111111
000000011
000000011
000000011
111111111

111111111
110000011
110000011
110000011
110000011

111111111
110000000
110000000
110000000
111111111

110000011
000000000
000000000
000000000
110000011

110000011
000000000
000000000
000000000
110000011

110000011
000000000
000000000
000000000
110000011

110000011
000000000
000000000
000000000
110000011
